2,2,2,2,2,2,2,2,2,2,2,2,2,2,2,2,2,2,2,2,2,2,2,2,2
2,0,0,0,0,0,2,2,0,0,0,0,0,0,0,0,0,0,0,0,0,0,0,0,2
2,0,0,0,0,0,2,2,0,0,0,0,0,0,0,0,0,0,0,0,0,0,0,0,2
2,0,0,0,0,0,2,2,0,0,0,0,0,0,0,0,0,0,0,0,0,0,0,0,2
2,0,0,0,0,0,2,2,0,0,0,16,16,16,0,0,0,0,0,0,0,0,0,0,2
2,0,0,0,0,0,2,2,0,0,0,0,0,2,0,0,0,0,0,0,0,0,0,0,2
2,0,0,0,0,0,2,2,0,0,0,0,0,2,0,0,0,0,0,0,0,0,0,0,2
2,0,0,0,0,0,2,2,16,16,0,0,0,2,0,0,0,0,0,0,0,0,0,0,2
2,0,0,0,0,0,2,2,0,0,0,0,0,2,0,0,0,0,0,0,0,0,0,0,2
2,0,0,0,0,0,2,2,0,0,0,0,0,2,0,0,0,0,0,0,0,0,0,0,2
2,0,0,0,0,0,2,2,0,0,0,16,16,2,0,0,0,0,0,0,0,0,0,0,2
2,0,0,0,0,0,2,2,0,0,0,0,0,2,0,0,0,0,0,0,0,0,0,0,2
2,0,0,0,0,0,2,2,0,0,0,0,0,2,0,0,0,0,0,0,0,0,0,0,2
2,0,0,0,0,0,2,2,16,16,0,0,0,2,0,0,0,0,0,0,0,0,0,0,2
0,0,0,0,0,0,0,0,0,0,0,0,0,2,0,0,0,0,0,0,0,0,0,0,2
0,0,0,0,0,0,0,0,0,0,0,0,0,2,0,0,0,0,0,0,0,0,0,0,2
16,16,16,16,0,0,16,16,0,0,0,16,16,2,0,0,0,0,0,0,0,0,0,0,2
2,2,2,2,0,0,2,2,16,0,0,0,0,0,0,0,0,0,0,0,0,0,0,0,2
2,2,2,2,0,0,2,2,2,16,0,0,0,0,0,0,0,0,0,0,0,0,0,0,2
2,2,2,2,0,0,2,2,2,2,16,0,0,0,0,0,0,0,0,0,0,0,0,0,0
2,2,2,2,0,0,2,2,2,2,2,16,0,0,0,0,0,0,0,0,0,0,0,0,0
2,2,2,2,2,2,2,2,2,2,2,2,16,0,0,0,0,0,0,0,0,0,0,16,16